gel	SKWREL
jab	SKWRAB
jag	SKWRAG
jar	SKWRAR
jazz	SKWRAZ
jet	SKWRET
jib	SKWREUB
jig	SKWREUG
job	SKWROB
jog	SKWROG
jot	SKWROT
jug	SKWRUG
jut	SKWRUT
val	SRAL
var	SRAR
vat	SRAT
ver	SRER
vet	SRET
vid	SREUD
vir	SREUR
vis	SREUS
vit	SREUT
zig	STKPWEUG
zip	STKPWEUP
zit	STKPWEUT
